Qual a resposta para a vida, o universo e tudo mais (digite os números)?	42
Qual a ciência que estuda a atmosfera da Terra e a climatologia?	METEOROLOGIA
Qual o time considerado o terror do nordeste?	SANTA CRUZ
Numa casa toda vermelha, de que cor é a parede da sala?	VERMELHA
Qual o código da melhor cadeira da UFPE?	IF975
O que é um maço de maconha enrolado num papel?	Baseado em fatos reais
Quantos fusos horários existem na Rússia (digite os números)?	11
Quantas teclas tem um piano clássico (digite os números)?	88
Quantos dias são necessários para a terra orbitar o sol?	365
Qual dos bairros a seguir ainda não foi descoberto pela humanidade:Dvor Proletarki, Susukino, Janga, Abraão Alab?	Janga
O que significa UFPE?	União de Fudidos de Pernambuco
Quantas voltas a luz dá na Terra em 1 segundo(digite o(s) número(s)?	8
Qual o jogo conhecido como jogo de corno?	Free Fire
Quem foi o compositor de Interstellar, a Origem, Batman Cavaleiro das trevas, entre outros?	Hans Zimmer
Qual o último lançamento da empresa Facebook?	Whatsapp 2
Qual a fonte dessas perguntas?	ARIAL
Quantos dias tem uma semana(digite o(s) número(s))?	7
Qual a capital da China?	Pequim
Qual o nome do roteirista de Watchmen?	Alan Moore
Qual o local mais frio já registrado pelo ser humano?	O Coração da morena
